E;5;down;
X;X;X;X;X;
X;P;;;X;
X;;S;;X;
X;;;;X;
X;;;;X;
X;;;;X;
X;;;;X;
X;;;;X;
X;X;X;X;X;