E;5;down;
X;X;X;X;X;
X;P;;;X;
X;B;B;B;X;
X;B;B;B;X;
X;B;B;B;X;
X;B;B;B;X;
X;B;B;B;X;
X;B;B;B;X;
X;B;B;B;X;
X;B;B;B;X;
X;G;B;G;X;
X;;G;;X;
X;;;;X;
X;;;;X;
X;;;;X;
X;;;;X;
X;;;;X;
X;;;;X;
X;;;;X;
X;;;;X;
X;;;;X;
X;;S;;X;
X;X;X;X;X;