X;X;X;X;X;X;X;X
X;;;;;;;X
X;;;;;;;X
X;;;;;;;X
X;;;;;;;X
X;;;;;;;X
X;;;;;;;X
X;;;;;;;X
X;;;G;;;;X
X;;;;;;;X
X;;;;;;;X
X;;;;;;;X
X;;;;;;;X
X;;;;;;;X
X;;;;;;;X
X;;;;;;;X
X;;;;;;;X
X;;;;;;;X
X;;;;;;;X
X;P;;;;E;;X
X;X;X;X;X;X;X;X
