S;5;down;
X;X;X;X;X;X;
X;P;;;;X;
X;;;;;X;
X;;;;S;X;
X;;;C;S;X;
X;;;;S;X;
X;;;;;X;
X;;;;;X;
X;;;;;X;
X;;;;;X;
X;;;;;X;
X;;;;;X;
X;X;X;X;X;X;