S;5;down;
X;X;X;X;X;X;
X;P;;;K;X;
X;K;K;;;X;
X;K;K;;;X;
X;;;;;X;
X;O;;;;X;
X;X;X;X;X;X;
X;X;X;X;X;X;
X;;;;;X;
X;;;;;X;
X;;;;S;X;
X;;;C;S;X;
X;;;;S;X;
X;;;;;X;
X;;;;;X;
X;;;;;X;
X;;;;;X;
X;;;;;X;
X;;;;;X;
X;X;X;X;X;X;