X;X;X;X;X;X;X
X;S;S;S;S;S;X
X;S;S;S;S;S;X
X;S;S;S;S;S;X
X;S;S;S;S;S;X
X;S;S;S;S;S;X
X;S;S;S;S;S;X
X;X;X;G;X;X;X
X;;;P;;;X
X;;;;;;X
X;;;;;;X
X;;;;;;X
X;;;;;;X
X;;;;;;X
X;;;;;;X
X;;;;;;X
X;;;;;;X
X;;;;;;X
X;;;;;;X
X;X;X;X;X;X;X
