X;X;X;X;X
X;S;A;S;X
X;S;;S;X
X;S;;S;X
X;S;;S;X
X;S;;S;X
X;S;;S;X
X;S;;S;X
X;X;X;X;X
