E;5;down;
X;X;X;X;X;
X;;;;X;
X;;S;;X;
X;;G;;X;
X;P;;;X;
X;;;;X;
X;;;;X;
X;;S;;X;
X;X;X;X;X;