E;5;down;
X;X;X;X;X;X;X;X;
X;;;;;;;X;
X;;;;;;;X;
X;;;;;;;X;
X;;;;;;;X;
X;;;;;;;X;
X;;;;;;;X;
X;;;S;;;;X;
X;G;G;S;G;G;G;X;
X;;;G;;;;X;
X;;;;;;;X;
X;;;;;;;X;
X;;;;;;;X;
X;;;;;;;X;
X;;;;;;;X;
X;;;;;;;X;
X;;;;;;;X;
X;;;;;;;X;
X;;;;;;;X;
X;;;;;;;X;
X;P;;;;;;X;
X;X;X;X;X;X;X;X;
